0 0 0 0 0 0 0 0 0 0 0 0 0 80 80 80 80 80 80 80 80 80 80 80 80 80 80 80 80 0 0 0 0 0 0 0 0 0 0 0 0 0 0 0 0 0 0 0 0 0 0 0 52 0 0 0 0 0 0 0 0 0 0 0 0 0 0 0 0 0 0 0 0 0 0 0 0 0 0 0 0 0 0 0 0 0 0 0 0 0 0 52 0 0 0 0 0 0 0 0 0 0 0 0 0 0 0 0 0 0 0 0 0 0 80 80 80 80 80 80 80 80 80 80 80 0 0 0 0 0 52 0 0 0 0 0 0 0 0 0 0 0 0 0 0 0 0 0 0 0 0 0 0 0 0 0 0 52 0 0 0 0 0 0 0 0 0 0 0 0 0 0 0 0 0 0 0 0 0 0 0 0 0 0 52 0 0 0 0 0 0 0 
0 0 0 0 0 0 0 0 0 0 0 0 0 0 80 80 80 80 80 0 0 0 0 0 0 0 0 0 0 0 0 0 0 0 0 0 0 0 0 0 0 0 0 0 0 0 0 0 0 0 0 0 52 0 0 0 0 0 0 0 46 0 0 0 0 0 0 0 0 0 0 0 0 0 0 0 0 0 0 0 0 0 0 0 0 0 0 0 0 0 0 52 0 0 0 0 0 0 0 0 0 0 0 51 0 0 0 51 0 0 0 0 0 0 64 64 80 80 80 80 80 80 80 64 64 0 0 0 0 0 52 0 0 0 0 0 0 0 0 79 0 0 79 0 0 0 0 0 0 0 0 0 0 0 0 0 0 52 0 0 0 0 0 0 0 0 22 0 0 0 0 0 0 0 0 0 0 0 0 0 0 0 0 0 52 0 0 0 0 0 0 59 
0 0 0 0 0 0 0 0 0 0 0 0 0 0 0 0 80 80 80 0 106 0 0 0 0 0 0 0 0 0 0 0 0 0 22 0 0 0 0 0 0 0 0 0 0 0 0 79 0 0 0 0 52 0 0 0 0 0 0 115 26 56 0 0 0 0 0 0 0 94 0 0 0 0 0 82 0 0 0 0 0 0 0 0 20 0 0 0 0 0 0 52 0 0 0 0 0 0 0 0 0 0 0 0 0 0 0 0 0 0 0 0 0 0 0 0 64 80 80 80 80 64 64 0 0 0 0 0 0 0 52 0 0 0 0 0 0 0 98 68 68 68 68 39 0 0 0 0 0 0 0 0 0 0 0 0 0 52 0 0 0 0 0 0 0 0 0 0 0 0 0 0 0 0 0 0 0 34 0 15 0 0 0 0 52 0 0 0 0 115 26 26 
0 0 0 0 0 0 0 0 0 0 0 0 0 0 0 0 0 80 80 80 80 80 80 80 80 0 0 0 0 0 0 0 0 115 56 0 0 0 0 0 0 0 98 68 68 68 68 68 68 68 39 0 52 0 0 0 0 0 0 0 0 0 0 0 0 0 0 0 75 94 0 0 0 0 0 0 0 0 0 0 0 0 0 0 0 0 0 0 0 0 0 52 0 0 0 0 0 0 0 0 0 0 0 0 0 0 43 0 0 0 34 91 0 0 0 0 0 64 64 64 64 0 0 0 0 0 0 0 76 0 52 0 0 0 0 0 0 0 114 114 114 114 114 114 0 0 0 0 0 0 0 0 0 0 0 0 0 52 0 0 0 0 0 0 0 5 5 5 5 0 0 0 0 0 0 0 42 42 42 42 42 42 42 42 52 0 0 0 0 0 0 0 
0 0 0 0 0 0 0 0 0 0 0 0 0 0 0 0 0 64 64 64 64 64 64 64 64 0 0 0 0 0 115 56 0 0 0 0 0 0 0 0 0 0 84 84 84 84 84 84 84 84 84 0 52 0 0 0 0 0 0 0 0 0 0 0 0 0 0 0 0 94 0 0 0 0 0 0 0 0 0 0 0 0 0 0 0 0 0 0 0 0 0 52 0 0 0 0 0 22 0 0 0 33 0 0 0 44 104 0 23 42 42 42 42 42 53 0 0 0 0 0 0 0 0 0 0 0 115 26 26 26 26 56 0 0 0 0 0 0 8 8 8 8 8 8 0 0 0 0 0 0 0 0 0 0 0 0 0 52 0 0 0 0 0 0 0 0 0 0 0 0 0 0 0 0 0 0 97 97 97 97 97 97 97 97 52 0 0 0 0 0 115 56 
0 0 0 0 0 0 0 0 0 0 0 0 0 0 0 0 0 0 0 22 0 0 0 0 0 0 0 0 0 0 0 0 0 0 0 0 0 0 0 0 0 0 73 38 54 54 54 38 54 54 103 0 52 0 0 0 0 0 0 0 0 0 0 0 0 0 0 0 0 94 0 0 0 0 81 81 81 81 81 0 0 0 81 81 81 81 0 0 0 0 0 52 0 0 0 0 0 0 0 0 44 104 0 0 0 0 0 0 19 97 97 97 97 97 108 0 0 0 0 0 0 0 0 0 0 0 0 0 0 0 0 0 0 0 0 0 0 0 8 8 38 38 8 8 22 0 0 0 0 0 94 0 0 0 0 0 0 52 0 0 0 0 0 0 0 0 0 0 0 0 0 0 59 0 0 0 97 97 97 97 97 97 97 97 52 0 0 0 0 0 0 0 
0 0 0 0 0 0 0 0 0 0 0 0 0 0 0 0 0 0 0 0 0 0 51 0 0 0 0 0 0 0 0 0 0 0 0 0 0 0 0 0 0 35 73 54 54 24 54 54 54 54 103 0 52 0 0 0 0 0 0 0 0 0 0 0 0 0 0 0 75 94 89 0 0 0 0 0 0 0 0 0 0 0 0 0 0 0 0 0 0 0 0 52 0 0 0 0 0 0 0 0 0 0 0 0 0 0 0 0 19 97 97 97 97 97 108 0 0 0 0 0 0 0 0 0 0 0 0 0 0 0 0 0 0 0 0 0 0 98 68 68 68 68 68 68 39 0 0 0 0 0 94 0 0 0 0 0 0 52 0 0 5 5 5 0 0 0 0 0 0 0 0 0 55 0 0 0 97 97 97 97 97 97 97 97 52 0 0 0 0 71 12 42 
94 89 0 0 0 0 0 0 0 0 0 0 0 0 0 0 0 0 0 82 0 0 0 0 0 115 26 56 0 0 0 0 0 0 0 0 0 0 0 3 35 35 73 54 54 24 54 54 54 54 103 109 52 0 0 0 0 0 0 0 0 0 0 0 0 0 0 0 0 94 95 0 0 0 0 0 0 0 0 0 0 0 0 0 0 0 0 0 0 0 0 52 0 0 0 0 0 44 104 0 0 0 0 0 0 0 0 0 19 97 97 97 97 97 108 0 0 0 0 0 0 0 0 0 0 0 0 0 0 0 0 0 0 0 0 0 0 114 114 114 114 114 114 114 114 0 0 0 0 0 94 0 0 0 0 0 0 52 0 0 0 0 0 0 0 0 0 0 0 0 0 0 0 0 0 0 97 97 37 97 97 97 97 97 52 0 0 0 28 41 97 97 
94 95 0 0 0 0 0 0 0 0 0 0 0 0 0 0 0 0 0 0 0 0 0 0 0 0 0 0 0 0 0 0 0 0 0 0 0 0 0 42 42 42 42 42 42 42 42 42 42 42 42 42 42 0 0 0 0 0 0 0 0 0 0 0 0 0 0 0 0 94 0 0 0 0 0 0 0 0 0 0 0 0 0 0 0 0 0 0 0 0 0 52 0 0 0 0 0 0 0 0 0 0 0 0 0 0 0 0 19 97 97 37 97 97 108 0 0 0 0 0 0 0 51 0 0 0 0 0 0 0 0 0 0 0 0 0 0 8 38 38 8 8 38 38 8 0 0 0 0 75 94 0 0 0 0 0 0 52 0 0 0 0 0 0 0 0 0 92 0 0 0 0 0 0 0 0 97 97 97 97 97 97 97 97 52 0 0 0 28 97 97 97 
94 0 0 0 0 0 0 0 0 0 0 0 0 20 0 0 0 0 0 0 0 0 0 0 0 0 0 0 0 0 0 0 0 0 0 0 0 0 0 97 97 97 97 97 97 97 97 97 97 97 97 97 97 0 0 0 0 0 0 0 0 0 0 0 0 0 0 0 0 94 0 0 0 0 0 0 0 0 0 0 0 0 0 0 0 0 0 0 0 0 0 52 0 0 44 104 0 0 0 0 0 0 0 0 0 0 0 0 97 97 97 97 97 97 97 0 0 0 0 0 0 0 0 0 0 0 0 0 0 0 0 0 0 0 0 0 0 8 114 114 8 8 114 114 8 0 0 0 0 0 94 0 0 0 0 0 0 52 0 0 0 0 0 0 0 5 5 5 5 0 0 0 0 0 0 0 42 42 42 42 42 97 97 97 52 0 0 0 28 97 97 97 
94 0 0 34 0 0 0 0 0 0 0 0 0 0 0 0 0 0 0 0 0 0 0 0 0 0 0 0 0 0 0 0 0 0 0 0 0 43 0 97 97 97 97 97 97 97 97 97 97 97 97 18 97 0 0 0 0 0 0 0 0 0 0 0 0 0 0 0 63 94 0 0 0 0 0 0 0 0 0 0 0 0 0 0 0 0 0 0 0 0 21 52 0 0 0 0 0 0 0 0 0 0 0 0 0 0 0 59 97 97 97 97 87 57 97 22 0 0 0 0 0 0 0 0 0 0 0 0 0 0 0 0 0 0 0 0 0 8 8 8 8 8 8 8 8 0 0 0 0 0 94 0 0 0 0 0 0 52 0 0 22 0 0 0 0 0 0 0 0 0 0 0 0 0 0 0 97 97 97 97 97 97 97 97 52 0 0 0 28 97 97 18 
42 42 42 42 42 42 53 0 0 0 0 0 0 0 0 0 0 0 5 5 5 0 0 0 0 5 5 5 5 0 0 0 0 0 59 71 12 42 42 112 83 83 83 83 112 97 97 97 97 97 97 97 97 0 0 0 0 0 0 0 0 0 0 0 0 0 42 42 42 42 42 53 0 0 0 0 0 0 51 0 0 0 0 51 0 0 0 0 23 42 42 42 42 53 0 0 0 0 0 0 0 0 0 0 0 0 0 88 97 97 97 97 27 116 97 0 0 0 36 0 0 36 0 0 36 0 0 36 0 0 0 0 109 34 0 91 2 8 8 8 8 69 8 8 8 49 91 0 0 0 94 0 0 0 0 0 0 52 0 0 0 0 0 0 0 0 0 0 0 0 0 0 0 0 0 0 97 97 18 97 97 97 97 97 52 0 0 93 28 97 97 97 
97 97 97 97 97 97 108 0 49 0 34 0 0 91 0 0 0 0 0 0 0 0 0 0 0 0 0 0 0 0 2 34 71 12 42 41 97 97 97 97 97 97 97 97 97 97 97 97 97 97 97 97 97 4 0 0 0 0 0 0 0 111 113 111 15 0 97 97 97 97 97 108 0 36 36 36 36 36 36 36 36 36 36 36 36 36 36 0 19 97 97 97 97 108 70 70 70 70 70 70 70 70 70 70 70 70 70 70 19 97 42 42 42 42 42 0 0 0 0 0 0 0 0 0 0 0 0 0 0 0 23 42 42 42 42 42 42 42 42 42 42 42 42 42 42 42 42 42 42 0 94 0 0 0 0 0 0 52 0 0 5 5 5 0 0 0 0 0 0 0 112 83 83 83 83 112 97 97 97 97 97 42 42 42 42 42 42 42 42 42 42 42 
97 18 97 97 97 97 97 42 42 42 42 42 42 42 42 42 53 0 0 0 0 0 0 0 0 0 0 0 23 42 42 42 42 42 42 97 97 97 97 97 97 97 97 97 97 42 42 42 42 42 42 42 42 42 53 0 0 0 0 0 0 23 42 42 42 42 42 42 97 97 97 108 0 0 0 0 0 0 0 0 0 0 0 0 0 0 0 0 19 97 97 97 97 108 40 40 40 40 40 40 40 40 40 40 40 40 40 40 19 97 97 97 97 97 97 0 0 0 0 0 0 0 0 0 0 0 0 0 0 0 19 97 97 97 97 97 97 97 97 97 97 97 97 97 97 97 97 97 97 43 94 34 0 0 0 0 0 52 21 0 0 0 0 0 0 0 0 0 0 0 97 97 97 97 97 97 97 97 97 97 97 97 97 97 97 97 97 97 97 97 97 97 
97 97 97 97 97 97 97 37 97 97 18 97 97 97 97 97 108 61 61 61 61 61 61 61 61 61 61 61 19 97 97 97 97 97 97 97 97 97 97 97 97 37 97 97 97 97 97 97 97 97 97 97 97 97 108 105 16 16 105 16 16 19 97 97 97 97 97 97 37 97 97 108 105 16 105 105 105 16 105 105 105 105 16 105 105 105 16 16 19 97 97 97 97 108 40 40 40 40 40 40 40 40 40 40 40 40 40 40 19 97 97 97 97 97 97 105 105 16 105 16 16 16 105 105 105 16 16 105 105 105 19 97 97 97 97 97 18 97 97 97 18 97 97 97 97 97 97 97 97 42 42 42 42 42 42 42 42 42 42 16 16 16 105 16 16 16 105 105 16 105 97 97 97 97 97 97 97 97 97 97 97 97 97 97 97 97 97 97 97 97 97 97 
97 97 97 18 97 97 97 97 97 97 97 97 97 97 97 97 97 31 31 31 31 65 65 65 31 31 31 31 97 97 97 97 97 97 97 97 18 97 97 97 97 97 97 97 97 97 97 97 97 97 97 97 97 97 108 6 6 6 6 6 6 19 97 97 97 97 97 97 97 97 97 108 6 6 6 6 6 6 6 6 6 6 6 6 6 6 6 6 19 97 97 97 97 108 40 40 40 40 40 40 40 40 40 40 40 40 40 40 19 97 97 97 97 97 97 6 6 6 6 6 6 6 6 6 6 6 6 6 6 6 19 97 97 97 97 97 97 97 97 97 97 97 97 97 18 97 97 97 97 97 97 97 97 97 97 97 97 97 97 6 6 6 6 6 6 6 6 6 6 6 97 97 97 97 97 97 97 97 97 97 97 97 97 97 97 97 97 97 97 97 97 97
17 17 17 17 17 17 17 17 17 17 107 0 0 0 0 0 0 0 0 0 0 0 0 0 0 0 0 0 0 0 0 0 0 0 0 0 0 0 0 0 0 0 0 0 0 0 0 0 0 0 0 0 0 0 0 0 0 0 0 0 0 0 0 0 0 0 77 17 17 17 17 17 107 0 0 0 0 0 0 0 0 0 0 0 0 0 0 0 0 0 0 0 0 0 0 0 0 0 0 0 0 0 0 0 0 0 0 0 0 0 0 0 0 0 0 0 0 0 0 0 0 0 0 0 0 0 0 0 0 0 0 0 0 0 0 0 0 0 0 0 0 0 0 77 17 17 17 17 17 17 17 17 17 17 17 17 17 107 0 0 0 0 0 0 0 0 0 0 0 0 0 0 0 0 0 0 0 0 0 0 0 0 0 0 0 0 0 0 0 0 0 0 
17 17 17 17 17 17 17 17 17 107 0 0 0 0 0 0 0 0 0 0 0 0 0 0 0 0 0 0 0 0 0 0 0 0 0 0 0 0 0 0 0 0 0 0 0 0 0 0 0 0 0 0 0 0 0 0 0 0 0 0 0 0 0 0 0 0 0 77 17 17 17 107 0 0 0 0 0 0 0 0 0 0 0 0 0 0 0 0 0 0 0 0 0 0 0 0 0 0 0 0 0 0 0 0 0 0 0 0 0 0 0 0 0 0 0 0 0 0 0 0 0 0 0 0 0 0 0 0 0 0 0 0 0 0 0 0 0 0 0 0 0 0 0 0 77 17 17 17 17 17 17 17 17 17 17 17 107 0 0 0 0 0 0 0 0 0 0 0 0 0 0 0 0 0 0 0 0 0 0 0 0 0 0 0 0 0 0 0 0 0 0 0 
17 17 17 17 17 17 17 17 107 0 0 0 0 0 0 0 0 0 0 0 0 0 0 0 0 0 0 0 0 0 0 0 0 0 0 0 0 0 0 0 0 0 0 0 0 0 0 0 0 0 0 0 0 0 0 0 0 0 0 0 0 0 0 0 0 0 0 0 100 100 100 0 0 0 0 0 0 0 0 0 0 0 0 0 0 0 0 0 0 0 0 0 0 0 0 0 0 0 0 0 0 0 0 0 0 0 0 0 0 0 0 0 0 0 0 0 0 0 0 0 0 0 0 0 0 0 0 0 0 0 0 0 0 0 0 0 0 0 0 0 0 0 0 0 0 100 77 17 17 17 17 17 17 17 17 107 0 0 0 0 0 0 0 0 99 0 0 0 0 10 0 0 0 0 0 0 0 0 0 0 0 0 0 0 0 0 0 0 0 0 0 0 
17 17 17 17 17 17 107 100 0 0 0 0 0 0 0 0 0 0 0 0 0 0 0 0 0 0 0 0 0 0 0 0 0 0 0 0 0 0 0 0 0 0 0 0 0 0 0 0 0 0 0 0 0 0 0 0 0 0 0 0 0 0 0 0 0 0 0 0 0 0 0 0 0 0 0 0 0 0 0 0 0 0 0 0 0 0 0 0 0 0 0 0 0 0 0 0 0 0 0 0 0 0 0 0 0 0 0 0 0 0 0 7 0 0 0 0 0 0 0 0 0 0 0 0 0 0 0 0 0 0 0 0 0 0 0 0 0 0 0 0 0 0 0 0 0 0 0 77 17 17 17 17 17 17 107 0 0 0 0 0 0 0 0 0 99 0 0 0 0 10 0 0 0 0 0 0 0 0 0 0 0 0 0 0 0 0 0 0 0 0 0 0 
17 17 17 17 17 107 0 0 0 0 0 0 0 0 0 0 0 0 0 0 0 0 0 0 0 0 0 0 0 0 0 0 0 0 0 0 0 0 0 0 0 0 0 0 0 0 0 0 0 0 0 0 0 0 0 0 0 0 0 0 0 0 0 0 0 0 0 0 0 0 0 0 0 0 0 0 0 0 0 0 0 0 0 0 0 0 0 0 0 0 0 0 0 0 0 0 0 0 0 0 0 45 0 0 0 0 0 0 0 0 0 0 0 0 0 0 0 0 0 0 0 0 0 0 0 0 0 0 0 0 0 0 0 0 0 0 0 0 0 0 0 0 0 0 0 0 0 0 77 17 17 17 107 100 0 0 0 0 0 0 0 0 0 0 99 0 0 0 0 10 0 0 0 0 0 0 0 0 0 0 0 0 0 0 0 0 0 0 0 0 0 0 
17 17 17 17 107 0 0 0 0 0 0 0 0 0 0 0 0 0 0 0 0 0 0 0 0 0 0 0 0 0 0 0 0 0 0 0 0 0 0 0 0 0 0 0 0 0 0 0 0 0 0 0 0 0 0 0 0 0 0 0 0 0 0 0 0 0 0 0 0 0 0 0 0 0 0 0 0 0 0 0 0 0 0 0 0 0 0 0 0 0 0 0 0 0 0 0 0 0 0 0 0 0 0 0 0 0 0 0 0 0 0 0 0 0 0 0 0 0 0 0 0 0 0 0 0 0 0 0 0 0 0 0 0 0 0 0 0 0 0 0 0 0 0 0 0 0 0 0 0 100 100 100 0 0 0 0 0 0 0 99 0 0 0 10 99 0 0 0 0 10 0 0 0 0 0 0 0 0 0 0 0 0 0 0 0 0 0 0 0 0 0 0 
17 17 107 100 0 0 0 0 0 0 0 0 0 0 0 0 0 0 0 0 0 0 0 0 0 0 0 0 0 0 0 0 0 0 0 0 0 0 0 0 0 0 0 0 0 0 0 0 0 0 0 0 0 0 0 0 0 0 0 0 0 0 0 0 0 0 0 0 0 0 0 0 0 0 0 0 0 0 0 0 0 0 0 0 0 0 0 0 0 0 0 0 0 0 0 0 0 25 25 0 0 0 0 0 0 0 0 0 0 0 0 0 0 0 0 0 0 0 0 0 0 0 0 0 0 0 0 0 0 0 0 0 0 0 0 0 0 0 0 0 0 0 0 0 0 0 0 0 0 0 0 0 0 0 0 0 0 0 0 99 0 0 0 10 99 0 0 0 0 10 0 0 0 0 0 0 0 0 0 0 0 0 0 0 0 0 0 0 0 0 0 0 
100 100 0 0 0 0 0 0 0 0 0 0 0 0 0 0 0 0 0 0 0 0 0 0 0 0 0 0 0 0 0 0 0 0 0 0 0 0 0 67 67 67 67 67 45 0 0 66 66 66 0 0 14 0 0 0 0 0 0 0 0 0 0 0 0 0 0 0 0 0 0 0 0 0 0 0 0 0 0 0 0 0 0 0 0 0 0 0 0 0 0 0 0 0 0 0 0 0 0 0 0 0 0 0 0 0 0 0 0 0 0 0 0 0 0 0 0 0 0 0 0 0 0 0 0 0 0 0 0 0 0 0 0 0 0 0 0 0 0 0 0 0 0 0 0 0 0 0 0 0 0 0 0 0 0 0 0 0 0 99 0 0 0 10 99 0 0 0 0 10 0 0 0 0 0 0 0 0 0 0 0 0 0 0 0 0 0 0 0 0 0 0 
0 0 0 0 0 0 0 0 0 0 0 0 0 0 0 0 0 0 0 0 0 0 0 0 0 0 0 0 0 0 0 0 0 0 0 0 0 0 0 0 0 0 0 0 0 0 0 0 0 0 0 0 0 0 0 0 0 0 0 0 0 0 0 0 0 0 0 0 0 0 0 0 0 0 0 0 0 0 0 0 0 0 0 0 0 0 0 0 0 0 0 0 0 0 45 0 0 0 0 0 0 0 0 0 0 0 0 0 0 0 0 0 0 0 0 0 0 0 0 0 0 0 0 0 0 0 0 0 0 0 0 0 0 0 0 0 0 0 25 85 0 0 25 85 0 0 0 0 0 0 0 0 0 0 0 0 0 0 0 99 0 0 0 10 99 0 0 0 0 10 0 0 0 0 0 0 0 0 0 0 14 0 0 0 0 0 0 0 0 0 0 0 
0 0 0 0 0 0 0 0 0 0 0 0 0 0 0 0 0 0 0 0 0 0 0 0 0 0 0 0 0 0 0 0 0 0 0 0 0 0 0 0 0 0 0 0 0 0 0 0 0 0 0 0 0 0 0 0 0 0 0 0 0 0 0 0 0 0 0 0 0 0 0 0 0 0 0 0 0 0 0 0 0 0 0 0 0 0 0 0 0 0 0 0 0 0 0 0 0 0 0 0 0 0 0 0 0 0 0 0 0 0 0 0 0 0 0 0 0 0 0 0 0 0 0 0 0 0 0 0 0 0 0 0 0 0 0 0 0 0 0 0 0 0 0 0 0 0 0 0 0 0 0 0 0 0 0 0 0 0 0 99 0 0 0 10 99 0 0 0 0 10 0 0 0 0 0 0 0 0 0 0 0 0 0 0 0 0 0 0 0 0 0 0 
67 67 67 67 0 0 0 0 0 0 0 0 0 0 0 0 0 99 0 0 0 10 0 0 99 0 0 0 0 10 0 0 0 0 0 0 0 0 0 0 0 0 0 0 0 0 0 0 0 0 0 0 0 0 0 0 0 0 0 0 0 0 0 0 0 0 0 0 0 0 0 0 0 0 0 0 0 0 0 0 0 0 0 0 0 0 0 0 0 0 45 45 0 0 0 0 0 0 0 0 0 0 0 0 0 0 0 0 0 0 0 0 0 0 0 0 0 0 0 0 0 0 0 0 0 0 0 0 0 0 0 0 0 0 0 0 0 0 0 0 0 0 0 0 0 0 0 0 0 0 0 0 0 0 0 0 0 0 0 99 0 0 0 10 99 0 0 0 0 10 0 0 0 0 0 0 0 0 0 0 0 0 0 0 0 0 0 0 0 0 0 0 
0 0 0 0 0 0 0 0 0 0 0 0 0 0 0 0 0 99 0 0 0 10 0 0 99 0 0 0 0 10 0 0 0 0 0 0 0 0 0 0 0 0 0 0 0 0 0 0 0 0 0 0 0 0 0 0 0 0 0 0 0 0 0 0 0 0 0 0 0 0 0 0 0 0 0 0 0 0 0 0 0 0 0 0 0 0 0 0 0 0 0 0 0 0 0 0 0 0 0 0 0 0 0 0 0 0 0 0 0 0 25 25 25 25 25 0 0 0 0 0 0 0 0 0 0 0 0 0 0 0 0 0 0 0 0 0 0 0 96 96 0 0 0 0 96 0 0 0 0 0 0 0 0 0 0 0 0 0 0 99 0 0 0 10 99 0 0 0 0 10 0 0 0 0 0 0 0 0 0 0 0 0 25 25 25 25 0 0 0 0 0 0 
0 0 0 0 0 0 0 0 0 67 67 67 66 66 67 0 0 99 0 0 0 10 0 0 99 0 0 0 0 10 0 0 0 14 0 0 0 0 0 0 0 0 0 0 0 0 0 66 66 66 66 66 0 0 0 0 0 0 0 0 0 0 0 0 0 0 0 0 0 0 0 0 0 0 0 0 0 0 0 0 0 0 0 0 0 0 0 0 0 0 0 0 0 0 0 0 0 0 0 0 0 0 0 0 0 0 0 0 0 0 0 0 0 0 0 0 0 0 0 0 0 0 0 0 0 0 0 0 0 0 0 0 0 0 0 0 0 0 0 0 0 0 0 0 0 0 0 0 0 0 0 0 0 0 0 0 0 0 0 99 0 0 0 10 99 0 0 0 0 10 0 0 0 0 0 0 0 0 0 0 0 0 0 0 0 0 0 0 0 0 0 0 
0 0 0 0 0 0 0 0 0 0 0 0 0 0 0 0 0 99 0 0 0 10 0 0 99 0 0 0 0 10 0 0 0 0 0 0 0 0 0 0 0 0 0 0 0 0 0 0 0 0 0 0 0 0 0 0 0 0 0 0 0 0 0 0 0 0 0 0 0 0 0 0 0 0 0 0 0 0 0 0 0 0 0 0 0 0 0 0 0 0 0 0 0 0 0 0 0 0 0 0 0 0 0 0 0 0 0 0 0 0 0 0 0 0 0 0 0 0 0 0 0 0 0 0 0 0 0 0 0 0 0 0 0 0 0 0 0 0 0 0 0 0 0 0 0 0 0 0 0 0 0 0 0 7 67 67 0 0 0 99 0 0 0 10 99 0 0 0 0 10 0 0 0 0 0 0 0 0 0 0 0 0 0 0 0 0 0 0 0 0 0 0 
0 0 0 0 0 0 0 0 0 0 0 0 0 0 0 0 0 99 0 0 0 10 0 0 99 0 0 0 0 10 0 0 0 0 0 0 0 0 0 0 0 0 0 0 0 0 0 0 0 0 0 0 0 0 0 0 0 0 0 0 0 0 0 0 0 0 0 0 0 0 0 0 0 0 0 0 0 0 0 0 0 0 0 0 0 0 0 0 0 0 0 0 0 0 0 0 0 0 0 0 0 0 0 0 0 0 0 0 0 0 0 0 0 0 0 0 0 0 0 0 0 0 0 0 0 0 0 0 0 0 0 0 0 0 0 0 0 0 0 0 0 0 0 0 0 0 0 0 0 0 0 0 0 0 0 0 0 0 0 99 0 0 0 10 99 0 0 0 0 10 0 0 0 0 0 0 0 0 0 0 0 0 0 0 0 0 0 0 0 0 0 0 
0 0 0 0 0 0 0 0 0 0 0 0 0 0 0 0 0 99 0 0 0 10 0 0 99 0 0 0 0 10 0 0 0 0 0 0 0 0 0 0 0 0 0 0 0 0 0 0 0 0 0 0 0 0 0 0 0 0 0 0 0 0 0 0 0 0 0 0 0 0 0 0 0 0 0 0 0 0 0 0 0 0 0 0 0 0 0 0 0 0 0 0 0 0 0 0 0 0 0 0 0 0 0 0 0 0 0 0 0 0 0 0 0 0 0 0 0 0 0 0 0 0 0 0 0 0 0 0 0 0 0 0 0 0 0 0 0 0 0 0 0 0 0 0 0 0 0 0 0 0 0 0 0 0 0 0 0 0 0 99 0 0 0 10 99 0 0 0 0 10 0 0 0 0 0 0 0 0 0 0 0 0 0 0 0 0 0 0 0 0 0 0